#############################
#                         $ #
#    ####            ##     #
#####                  #    #
#          ####      ##     #
#                           #
# ###          #   ##       #
#    ####                   #
#            ##     ####### #
#  ########    #            #
#      #     ##    ###      #
#      #    #$    ##0#      #
#      #     ###     #      #
#                 ####$     #
#############################
